NO ./textures/colorstone.xpm
SO ./textures/bluestone.xpm
WE ./textures/purplestone.xpm
EA ./textures/redbrick.xpm


F 2,255,100
C 255,225,255



     1111111111111111111111111
     1000000000110000000000001
     1011000001110000000000001
     1001000000000000000000001
111111111011000001110000000001
100000000011000001110111111111111
11110111111111011100000010001
111101111111110111101010010001
11000000110101011100010010001
10000000000000001100000010001
10000000000000001101010010001
1100001110101011111011110N0111
11110111 1110101 101111010001
11111111 111111 111111111111






