NO ./textures/colorstone.xpm
SO ./textures/bluestone.xpm
WE ./textures/purplestone.xpm
EA ./textures/redbrick.xpm

C       200 ,     230,           255
F 80,60,30

        1111111111111111111111111
        1000000000000000000000001
        1011000000000000000000001
        1011000000000000000000001
        1011000000000000000000001
        1011000000000000000000001
        100000S000000000000000001
        1011001000000000000000001
        1001000000000000000111111
1111111110110000011100000001
100000000011000001110011111111111
1000000000111101110000001
11111111111111011101001011111
11111111110101011100000010001
10000000000000001100000010001
10000000000000001101010010001
11000001110101011111011110011
11111111 1110101 101111010001
11111111 1111111 111111111111



